"filename", "language", "Python", "Batch", "RST", "TeX", "comment", "blank", "total"
"c:\Python313\Lib\site-packages\rivtlib\README.rst", "RST", 0, 0, 3, 0, 0, 2, 5
"c:\Python313\Lib\site-packages\rivtlib\__init__.py", "Python", 78, 0, 0, 0, 0, 26, 104
"c:\Python313\Lib\site-packages\rivtlib\__main__.py", "Python", 51, 0, 0, 0, 0, 17, 68
"c:\Python313\Lib\site-packages\rivtlib\api.py", "Python", 139, 0, 0, 0, 10, 45, 194
"c:\Python313\Lib\site-packages\rivtlib\check.py", "Python", 61, 0, 0, 0, 2, 24, 87
"c:\Python313\Lib\site-packages\rivtlib\cmds.py", "Python", 233, 0, 0, 0, 10, 39, 282
"c:\Python313\Lib\site-packages\rivtlib\folders.py", "Python", 52, 0, 0, 0, 3, 2, 57
"c:\Python313\Lib\site-packages\rivtlib\params.py", "Python", 62, 0, 0, 0, 3, 8, 73
"c:\Python313\Lib\site-packages\rivtlib\parse.py", "Python", 180, 0, 0, 0, 4, 12, 196
"c:\Python313\Lib\site-packages\rivtlib\scripts\genpdocs.cmd", "Batch", 0, 1, 0, 0, 0, 1, 2
"c:\Python313\Lib\site-packages\rivtlib\scripts\pdfdoc.sty", "TeX", 0, 0, 0, 47, 11, 4, 62
"c:\Python313\Lib\site-packages\rivtlib\scripts\reportmerge.py", "Python", 181, 0, 0, 0, 3, 23, 207
"c:\Python313\Lib\site-packages\rivtlib\scripts\rst2html.py", "Python", 12, 0, 0, 0, 4, 8, 24
"c:\Python313\Lib\site-packages\rivtlib\scripts\rst2html4.py", "Python", 14, 0, 0, 0, 4, 9, 27
"c:\Python313\Lib\site-packages\rivtlib\scripts\rst2html5.py", "Python", 15, 0, 0, 0, 14, 7, 36
"c:\Python313\Lib\site-packages\rivtlib\scripts\rst2latex.py", "Python", 16, 0, 0, 0, 4, 7, 27
"c:\Python313\Lib\site-packages\rivtlib\scripts\rst2man.py", "Python", 15, 0, 0, 0, 4, 8, 27
"c:\Python313\Lib\site-packages\rivtlib\scripts\rst2odt.py", "Python", 17, 0, 0, 0, 4, 10, 31
"c:\Python313\Lib\site-packages\rivtlib\scripts\rst2odt_prepstyles.py", "Python", 45, 0, 0, 0, 5, 18, 68
"c:\Python313\Lib\site-packages\rivtlib\scripts\rst2pseudoxml.py", "Python", 12, 0, 0, 0, 4, 8, 24
"c:\Python313\Lib\site-packages\rivtlib\scripts\rst2s5.py", "Python", 13, 0, 0, 0, 4, 8, 25
"c:\Python313\Lib\site-packages\rivtlib\scripts\rst2xetex.py", "Python", 17, 0, 0, 0, 4, 7, 28
"c:\Python313\Lib\site-packages\rivtlib\scripts\rst2xml.py", "Python", 12, 0, 0, 0, 4, 8, 24
"c:\Python313\Lib\site-packages\rivtlib\scripts\tex2text.py", "Python", 136, 0, 0, 0, 3, 7, 146
"c:\Python313\Lib\site-packages\rivtlib\setup.py", "Python", 13, 0, 0, 0, 0, 2, 15
"c:\Python313\Lib\site-packages\rivtlib\tags.py", "Python", 288, 0, 0, 0, 30, 70, 388
"c:\Python313\Lib\site-packages\rivtlib\tools.py", "Python", 0, 0, 0, 0, 0, 1, 1
"c:\Python313\Lib\site-packages\rivtlib\toyreport\__init__.py", "Python", 254, 0, 0, 0, 12, 93, 359
"c:\Python313\Lib\site-packages\rivtlib\toyreport\__main__.py", "Python", 133, 0, 0, 0, 7, 45, 185
"c:\Python313\Lib\site-packages\rivtlib\units.py", "Python", 88, 0, 0, 0, 33, 9, 130
"c:\Python313\Lib\site-packages\rivtlib\unum\__init__.py", "Python", 0, 0, 0, 0, 4, 1, 5
"c:\Python313\Lib\site-packages\rivtlib\unum\core.py", "Python", 418, 0, 0, 0, 3, 145, 566
"c:\Python313\Lib\site-packages\rivtlib\unum\exceptions.py", "Python", 37, 0, 0, 0, 0, 16, 53
"c:\Python313\Lib\site-packages\rivtlib\unum\utils.py", "Python", 68, 0, 0, 0, 0, 28, 96
"c:\Python313\Lib\site-packages\rivtlib\vals.py", "Python", 292, 0, 0, 0, 28, 51, 371
"c:\Python313\Lib\site-packages\rivtlib\write.py", "Python", 1119, 0, 0, 0, 94, 135, 1348
"Total", "-", 4071, 1, 3, 47, 315, 904, 5341